images/lvl5.jpg
2 3 234 28
1 1 0 1 1 1 1 1 1 1 1 1 1 1 1 1 1 1 1 1 
1 0 0 0 0 0 0 0 0 0 0 0 0 0 0 0 0 0 0 1 
1 1 1 1 1 1 1 1 1 1 1 1 1 1 1 1 1 1 0 1 
1 3 1 3 1 0 0 0 0 0 0 0 0 0 0 0 0 0 0 1 
1 0 1 0 1 0 0 0 1 1 1 1 1 1 1 1 1 1 3 1 
1 0 1 0 1 0 0 0 1 0 1 0 0 0 0 0 0 0 0 1 
1 0 1 0 1 0 0 0 0 0 1 0 0 1 1 0 1 0 4 1 
1 0 1 0 1 1 1 1 0 3 1 0 0 1 1 0 1 0 2 1 
1 0 1 0 1 0 0 0 0 0 0 0 1 1 1 1 1 1 1 1 
1 0 1 0 1 1 1 0 0 0 1 0 0 1 1 0 0 0 0 1 
1 0 1 0 1 0 0 0 1 1 1 0 0 1 1 0 0 0 0 1 
1 0 1 0 1 0 0 0 0 0 0 0 0 1 1 1 1 1 0 1 
1 0 1 0 1 0 0 1 1 0 0 0 0 1 0 0 0 0 0 1 
1 0 1 0 1 0 0 1 1 0 0 0 0 1 0 0 0 0 0 1 
1 0 0 0 0 0 0 1 1 1 1 0 0 0 0 0 0 0 0 1 
1 0 1 3 1 1 1 1 1 1 1 1 1 1 1 1 1 1 1 1 
