images/lvl5.jpg
2 5 207 27
1 1 0 1 1 1 1 1 1 1 1 1 1 1 1 1 1 1 1 1 
1 0 0 0 0 0 0 0 0 0 0 0 0 0 0 0 0 0 0 1 
1 1 1 1 1 1 1 1 1 1 1 1 1 1 1 1 1 1 0 1 
1 3 1 3 1 0 0 0 0 0 0 0 0 0 0 0 0 0 0 1 
1 0 1 0 1 0 0 0 1 1 1 1 1 1 1 1 1 1 3 1 
1 0 1 0 1 0 0 0 1 0 1 0 0 0 0 0 0 0 0 1 
1 0 1 0 1 0 0 0 0 0 1 0 0 1 1 0 1 0 0 1 
1 0 1 0 1 1 1 1 0 3 1 0 0 1 1 2 1 0 2 1 
1 0 1 0 1 0 0 0 0 0 0 0 1 1 1 1 1 1 1 1 
1 0 1 0 1 1 1 0 0 0 1 0 0 1 1 0 0 0 0 1 
1 0 1 0 1 0 0 0 1 1 1 0 0 1 1 0 0 4 0 1 
1 0 1 0 1 0 0 0 0 0 3 0 0 1 1 1 1 1 0 1 
1 0 1 0 1 0 0 1 1 0 0 0 0 1 0 0 0 0 0 1 
1 0 1 0 1 0 0 1 1 0 0 0 0 1 0 0 0 0 0 1 
1 0 0 0 0 0 0 1 1 1 1 0 0 0 0 0 0 0 0 1 
1 3 1 3 1 1 1 1 1 1 1 1 1 1 1 1 1 1 1 1 
