images/menu.jpg
0 135 89
1 1 1 1 1 1 1 1 1 1 1 1 1 1 1 1 1 1 1 1 
1 0 1 1 1 1 1 1 1 1 1 1 1 1 1 1 1 1 1 1 
1 0 0 0 0 0 0 0 0 0 0 0 0 0 0 0 0 0 0 1 
1 0 0 0 0 0 0 0 0 0 0 0 0 0 0 0 1 1 0 1 
1 0 0 1 0 0 1 1 1 0 0 0 1 1 0 0 1 1 1 1 
1 0 0 0 0 0 1 0 0 0 1 1 1 0 0 0 0 0 0 1 
1 0 0 0 1 1 1 1 1 0 0 0 0 1 1 0 1 1 0 1 
1 0 0 0 0 0 0 0 0 0 0 1 0 1 0 0 0 1 0 1 
1 0 0 0 1 0 0 0 1 1 1 0 0 1 0 1 0 1 0 1 
1 0 1 0 1 0 0 0 0 1 0 0 1 0 0 0 1 1 0 1 
1 0 0 0 1 0 0 1 0 1 0 0 1 0 0 1 0 0 0 1 
1 0 0 0 1 0 0 0 0 1 1 0 0 0 0 0 0 0 0 1 
1 0 0 0 2 3 0 0 0 1 0 0 0 0 1 0 0 1 1 1 
1 0 1 1 1 1 1 1 1 1 1 1 1 1 1 1 1 1 1 1 
1 0 0 0 0 0 0 0 0 0 0 0 0 0 0 0 0 0 1 1 
1 1 1 1 1 1 1 1 1 1 1 1 1 1 1 1 1 1 1 1 
