images/lvl_duck_pond.jpg
6 3 789 65
1 1 1 1 1 1 1 1 1 1 1 1 1 1 1 1 1 1 1 1 
1 0 0 0 0 0 0 0 0 0 0 0 0 0 0 0 0 0 0 1 
1 0 0 0 0 0 0 0 0 0 0 0 0 0 0 0 0 0 0 1 
1 3 3 3 1 1 0 0 1 1 0 0 1 1 3 3 3 3 3 1 
1 0 3 3 1 1 0 0 1 1 0 0 1 1 3 3 3 3 0 1 
1 0 0 0 0 0 0 0 0 0 0 0 0 0 0 0 0 0 0 1 
1 0 0 0 1 1 1 1 1 1 1 1 1 1 1 1 0 0 0 1 
1 0 0 0 0 0 0 0 0 0 0 0 0 0 0 0 0 0 0 1 
1 0 0 0 0 0 0 0 3 0 3 0 0 0 0 0 0 4 0 1 
1 0 0 0 0 0 0 0 3 3 3 0 0 0 0 0 0 0 0 1 
1 0 3 3 1 1 0 0 1 1 0 0 1 1 3 3 3 0 0 1 
1 3 3 3 1 1 0 0 1 1 0 0 1 1 3 3 3 3 3 1 
1 0 0 0 0 0 0 0 0 0 0 0 0 0 0 0 0 0 0 1 
1 0 0 0 1 1 1 1 1 1 1 1 1 1 1 1 0 0 0 1 
1 2 0 0 0 0 0 0 0 0 0 0 0 0 0 0 0 0 2 1 
1 1 1 1 1 1 1 1 1 1 1 1 1 1 1 1 1 1 1 1 
