images/books.jpg
10 3 1396 231
1 1 1 1 1 1 1 1 1 1 1 1 1 1 1 1 1 1 1 1 
1 0 0 0 0 1 0 0 0 0 0 1 0 0 1 0 0 0 0 1 
1 0 3 3 4 1 0 0 0 0 1 3 0 0 1 0 3 3 0 1 
1 0 3 3 2 1 0 0 0 0 1 0 0 0 1 0 3 3 0 1 
1 0 0 0 0 0 0 0 0 0 1 0 0 0 0 0 0 0 0 1 
1 1 3 3 3 0 0 0 0 1 3 0 0 0 0 3 3 3 1 1 
1 1 0 0 0 0 0 0 0 1 0 0 0 0 0 0 0 0 1 1 
1 1 1 1 0 3 1 0 0 0 0 0 0 1 3 0 1 1 1 1 
1 1 0 1 1 1 1 0 0 0 0 0 0 1 1 1 1 0 1 1 
1 1 0 0 0 0 0 0 0 0 0 1 0 0 0 0 0 0 1 1 
1 1 3 3 3 0 0 0 0 0 3 1 0 0 0 3 3 3 1 1 
1 0 0 0 0 0 0 0 0 0 1 0 0 0 0 0 0 0 0 1 
1 0 3 3 0 1 0 0 0 0 1 0 0 0 1 0 3 3 0 1 
1 0 3 3 0 1 0 0 0 3 1 0 0 0 1 0 3 3 0 1 
1 0 0 0 0 1 0 0 0 1 0 0 0 0 1 0 0 0 0 1 
1 1 1 1 1 1 1 1 1 1 1 1 1 1 1 1 1 1 1 1 
